Der Hafen – port
Buchstabieren – to spell
hinzufügen – to add
Ändern – to change
Versuchen – to try
Erhalten – to receive
Niedrig – low
die Linie – line
Abweichen – to differ
Die Ursache – cause
Der Zustand – condition
Der Umzug – move
Verwenden – to use
Die Anzahl – number
Die seite – side
Besitzen – own
Die Anlage – plant
Die Abdeckung – cover
Die Lebensmittel – food
Der Gedanke – thought
Schwer – hard
Scheinen- seem
Anschauen – look at
Schmutzig – dirty
Heftig- violent
Der Führerschein – driver’s license
Reichhaltig – rich
Erreichen – to reach
Wehen – to blow
Der Keller – basement
Der Wolkenkratzer – skyscraper
Der Stock – sartuli
Das Dachgeschoss – loft
Die umgebung – vicinity
Die gardine – curtaine
Der pfeil – arrow
Der Gegenstand – object
Der schornstein – chimney
Der bewohner – resident
Beobachten –  დააკვირდე
Lagern – to store
Die pfanne – frying pan
Der vorhang – curtains
Stellen – dadgma
Legen – dadeba
Setzen (sich) – dajdoma
Arbeitgeber – employer
Das Einkommen – income
Besichtigen – view
Die aussicht - მსოფლმხედველობა
Das angebot – offer
Berühmt – famous
Die abteilung – department
Günstig – cheap
Zumindest – at least
Der eingang - entrance
Der Ausgang – exit
Die querstraße - ქუჩების გადაკვეთა
Geradeaus - პირდაპირ
Abbiegen - მოხვევა
Das schubfach - უჯრა
Die schublade - უჯრა
Die tastatur - კლავიატურა
Der Ausblick - ხედი
Üben - ვარჯიში
Stören – to disturb
Die beförderung - დაწინაურება
Springen – to jump
Der Fußgängerweg - ტროტუარი
Schieben - ხელის კვრა
Fleißig - ბეჯითი
Bestehen – to pass
Neulich - recently
Ehrenamtlich – valuntarily
Mindern – to reduce
Erhöhen – to increase
Fremd - უცხო
Zugreifen – to access
Riesig – huge
Knüpfen – მიბმა
Überlegen – განხილვა 
Ständig – constantly
Die Glocke - ზარი
Leisten – to afford
Unbedingt – absolutely
Drüben – over there
Schüchtern – shy
Meistens – mostly
Bemühung – effort
was sonst – what else
unsinnig – nonsensical
kündigen – to quit
nachhaltig – sustainable
allgemein - generally
betreuen – look after
selbständig – independantly
zuständig – responsible
rein – mere
überlegen - განიხილავენ
bieten – to offer
abschließen - to complete
das gehalt - salary
fest - firmly
die Herausforderung - challenge
verabschieden - to say goodbye
beeindruckend- impressive
die Schicht - layer
der Notfall - emergency
behandeln - to treat
beibringen - to teach
lohnen sich - it is worth
zuverlässig - reliable
erheben - raise
sogar - even
wieso - why
herausfinden - to find out
gar nicht - not at all
vereinbaren - შეთანხმება
schmerzhaft - painful
unhöflich - rude
schlimm - bad
einschätzen - to judge
das Gedächtnis - memory
vorstellen mir - imagine
bescheiden - modest
geduldig - patient
abhauen - to run away
verabreden - make a date
​der Durchschnitt - avarage
mittlerweile - in the meantime
lügen - to lie
ebenfalls - also
farbenfroh - colorful
der Fahrschein - ticket
die Schuld - debt
betonen - to emphasize
unterstreichen - underline
herum - around
der Abfall - waste
halten von - to think of
brüllen - roar
verbrauchen - consume
besprechen - to discuss
der Geldbeutel - საფულე
achten - to respect
achten auf - pay attention to
sich bewerben auf - to apply
die stelle - job
der mitarbeiter - employee
ansprechen - to address
geil - awesome
begeistern sich für - be enthusiastic for
das wissen - knowledge
abschrecken - to deter
ablehnen - to refuse
nachholen - to make up
flüssig - fluent
sparen - to save
ist mir aufgefallen - i noticed 
schaffen - to manage
ausdrücken - to express
vollständig - complete
ärgerlich - annoying
bevorzugen - to prefer
notwendig - necessary
beschäftigen sich mit - to deal with
die Voraussetzung - requirement
umwandeln - to convert
ausführlich - detailed
die Lücke - gap
verfassen - to write
beruhigen - to calm
verständigen sich - to communicate
jedoch - however
nochmal - again
vornehmen sich - to undertake
deswegen - therefore
eifrig - eager
damals - at that time
​die Veranstaltung - event
solche (jobs) - such (jobs)
deutlich - clear
​das Verfahren - process
üblich - usual
angestellt - employed
das verhältnis - relationship
eng - close
vorherige - previous
krass - cool
heilig - holy
Teilnehmer - participant
immer noch - still
übrigens - by the way
quasi - so to say
nun - so
woanders - somewhere else
ausnutzen - to exploit
loswerden - to get rid of
die Last - load, burden
beerdigen - to bury
zurücklegen - to return
unheimlich - scary
eigen - own
einfallen - to come up 
die Menge - crowd
betreiben - to operate
überleben - to survive
längerfristig - long run
vorhaben - to refuse
sich weigern - to refuse
die Wahrnehmung - perception
stets - always
vertreten - represent
bereits - already
aufgrund (genitiv) - due to
ablaufen - expire